CCH: 長洲
CWB: 清水灣
HKA: 香港國際機場
HKO: 香港天文台
HKP: 香港公園
HKS: 黃竹坑
HPV: 跑馬地
JKB: 將軍澳
KLT: 九龍城
KP: 京士柏
KSC: 滘西洲
KTG: 觀塘
LFS: 流浮山
NGP: 昂坪
PEN: 坪洲
PLC: 大美督
SE1: 啟德跑道公園
SEK: 石崗
SHA: 沙田
SKG: 西貢
SKW: 筲箕灣
SSH: 上水
SSP: 深水埗
STY: 赤柱
TC: 大老山
TKL: 打鼓嶺
TMS: 大帽山
TPO: 大埔（自然環境保護研究中心）
TU1: 屯門兒童及青少年院
TW: 荃灣城門谷
TWN: 荃灣
TY1: 新青衣站
TYW: 北潭涌(鯽魚湖)
VP1: 山頂
WGL: 橫瀾島
WLP: 濕地公園
WTS: 黃大仙
YCT: 大埔（元洲仔公園）
YLP: 元朗公園